YEAR,STATE,SECURITY,TRADE,PTRADE,LTRADE,PROFIT,LOSS
2001,FUTURE,NIFTY,373,112,261,10640,24795
2001,OPTION,NIFTY,827,87,740,8265,70300
2001,STOCK,NIFTY,501,482,19,45790,1805
2001,FUTURE,RELIANCE,702,455,247,43225,23465
2001,OPTION,RELIANCE,484,21,463,1995,43985
2001,STOCK,RELIANCE,377,356,21,33820,1995
2001,FUTURE,SBIN,520,283,237,26885,22515
2001,OPTION,SBIN,246,122,124,11590,11780
2001,STOCK,SBIN,297,293,4,27835,380
2001,FUTURE,ICICI,287,251,36,23845,3420
2001,OPTION,ICICI,747,425,322,40375,30590
2001,STOCK,ICICI,447,38,409,3610,38855
2001,FUTURE,LT,323,207,116,19665,11020
2001,OPTION,LT,333,296,37,28120,3515
2001,STOCK,LT,453,347,106,32965,10070
2001,FUTURE,CIPLA,547,412,135,39140,12825
2001,OPTION,CIPLA,442,105,337,9975,32015
2001,STOCK,CIPLA,593,153,440,14535,41800
2001,FUTURE,ONGC,857,578,279,54910,26505
2001,OPTION,ONGC,621,154,467,14630,44365
2001,STOCK,ONGC,871,212,659,20140,62605
2001,FUTURE,DLF,792,561,231,53295,21945
2001,OPTION,DLF,484,62,422,5890,40090
2001,STOCK,DLF,370,34,336,3230,31920
2001,FUTURE,UNILEVER,281,115,166,10925,15770
2001,OPTION,UNILEVER,771,576,195,54720,18525
2001,STOCK,UNILEVER,831,656,175,62320,16625
2001,FUTURE,APOLLO,348,231,117,21945,11115
2001,OPTION,APOLLO,465,116,349,11020,33155
2001,STOCK,APOLLO,714,108,606,10260,57570
2001,FUTURE,BHEL,779,712,67,67640,6365
2001,OPTION,BHEL,490,115,375,10925,35625
2001,STOCK,BHEL,698,520,178,49400,16910
2001,FUTURE,SRIRAM,627,508,119,48260,11305
2001,OPTION,SRIRAM,484,226,258,21470,24510
2001,STOCK,SRIRAM,538,531,7,50445,665
2001,FUTURE,MANNA,359,285,74,27075,7030
2001,OPTION,MANNA,750,24,726,2280,68970
2001,STOCK,MANNA,419,328,91,31160,8645
2001,FUTURE,LUPIN,748,573,175,54435,16625
2001,OPTION,LUPIN,502,280,222,26600,21090
2001,STOCK,LUPIN,684,324,360,30780,34200
2001,FUTURE,DRL,683,137,546,13015,51870
2001,OPTION,DRL,572,32,540,3040,51300
2001,STOCK,DRL,659,609,50,57855,4750
2001,FUTURE,TCIL,900,372,528,35340,50160
2001,OPTION,TCIL,215,122,93,11590,8835
2001,STOCK,TCIL,945,124,821,11780,77995
2001,FUTURE,CONCUR,366,181,185,17195,17575
2001,OPTION,CONCUR,902,392,510,37240,48450
2001,STOCK,CONCUR,582,123,459,11685,43605
2002,FUTURE,NIFTY,675,186,489,17670,46455
2002,OPTION,NIFTY,537,505,32,47975,3040
2002,STOCK,NIFTY,665,119,546,11305,51870
2002,FUTURE,RELIANCE,236,4,232,380,22040
2002,OPTION,RELIANCE,791,104,687,9880,65265
2002,STOCK,RELIANCE,304,161,143,15295,13585
2002,FUTURE,SBIN,553,117,436,11115,41420
2002,OPTION,SBIN,604,247,357,23465,33915
2002,STOCK,SBIN,617,426,191,40470,18145
2002,FUTURE,ICICI,235,181,54,17195,5130
2002,OPTION,ICICI,526,297,229,28215,21755
2002,STOCK,ICICI,935,786,149,74670,14155
2002,FUTURE,LT,244,22,222,2090,21090
2002,OPTION,LT,850,254,596,24130,56620
2002,STOCK,LT,725,422,303,40090,28785
2002,FUTURE,CIPLA,365,135,230,12825,21850
2002,OPTION,CIPLA,225,209,16,19855,1520
2002,STOCK,CIPLA,669,287,382,27265,36290
2002,FUTURE,ONGC,349,133,216,12635,20520
2002,OPTION,ONGC,458,355,103,33725,9785
2002,STOCK,ONGC,618,50,568,4750,53960
2002,FUTURE,DLF,491,103,388,9785,36860
2002,OPTION,DLF,477,261,216,24795,20520
2002,STOCK,DLF,961,791,170,75145,16150
2002,FUTURE,UNILEVER,771,306,465,29070,44175
2002,OPTION,UNILEVER,244,181,63,17195,5985
2002,STOCK,UNILEVER,529,299,230,28405,21850
2002,FUTURE,APOLLO,969,99,870,9405,82650
2002,OPTION,APOLLO,274,39,235,3705,22325
2002,STOCK,APOLLO,419,253,166,24035,15770
2002,FUTURE,BHEL,902,674,228,64030,21660
2002,OPTION,BHEL,332,244,88,23180,8360
2002,STOCK,BHEL,447,195,252,18525,23940
2002,FUTURE,SRIRAM,792,457,335,43415,31825
2002,OPTION,SRIRAM,678,283,395,26885,37525
2002,STOCK,SRIRAM,556,268,288,25460,27360
2002,FUTURE,MANNA,373,210,163,19950,15485
2002,OPTION,MANNA,291,179,112,17005,10640
2002,STOCK,MANNA,706,345,361,32775,34295
2002,FUTURE,LUPIN,279,202,77,19190,7315
2002,OPTION,LUPIN,822,316,506,30020,48070
2002,STOCK,LUPIN,945,729,216,69255,20520
2002,FUTURE,DRL,751,457,294,43415,27930
2002,OPTION,DRL,226,30,196,2850,18620
2002,STOCK,DRL,965,175,790,16625,75050
2002,FUTURE,TCIL,349,39,310,3705,29450
2002,OPTION,TCIL,625,339,286,32205,27170
2002,STOCK,TCIL,473,264,209,25080,19855
2002,FUTURE,CONCUR,678,611,67,58045,6365
2002,OPTION,CONCUR,682,274,408,26030,38760
2002,STOCK,CONCUR,642,255,387,24225,36765
2003,FUTURE,NIFTY,954,540,414,51300,39330
2003,OPTION,NIFTY,392,290,102,27550,9690
2003,STOCK,NIFTY,950,488,462,46360,43890
2003,FUTURE,RELIANCE,413,95,318,9025,30210
2003,OPTION,RELIANCE,754,257,497,24415,47215
2003,STOCK,RELIANCE,748,630,118,59850,11210
2003,FUTURE,SBIN,337,122,215,11590,20425
2003,OPTION,SBIN,774,409,365,38855,34675
2003,STOCK,SBIN,509,478,31,45410,2945
2003,FUTURE,ICICI,788,523,265,49685,25175
2003,OPTION,ICICI,433,269,164,25555,15580
2003,STOCK,ICICI,335,193,142,18335,13490
2003,FUTURE,LT,791,125,666,11875,63270
2003,OPTION,LT,870,760,110,72200,10450
2003,STOCK,LT,336,73,263,6935,24985
2003,FUTURE,CIPLA,981,130,851,12350,80845
2003,OPTION,CIPLA,250,240,10,22800,950
2003,STOCK,CIPLA,622,93,529,8835,50255
2003,FUTURE,ONGC,757,203,554,19285,52630
2003,OPTION,ONGC,831,526,305,49970,28975
2003,STOCK,ONGC,762,411,351,39045,33345
2003,FUTURE,DLF,640,250,390,23750,37050
2003,OPTION,DLF,651,557,94,52915,8930
2003,STOCK,DLF,878,870,8,82650,760
2003,FUTURE,UNILEVER,513,403,110,38285,10450
2003,OPTION,UNILEVER,950,523,427,49685,40565
2003,STOCK,UNILEVER,410,16,394,1520,37430
2003,FUTURE,APOLLO,891,646,245,61370,23275
2003,OPTION,APOLLO,987,810,177,76950,16815
2003,STOCK,APOLLO,855,506,349,48070,33155
2003,FUTURE,BHEL,973,706,267,67070,25365
2003,OPTION,BHEL,983,108,875,10260,83125
2003,STOCK,BHEL,673,346,327,32870,31065
2003,FUTURE,SRIRAM,358,107,251,10165,23845
2003,OPTION,SRIRAM,413,208,205,19760,19475
2003,STOCK,SRIRAM,250,47,203,4465,19285
2003,FUTURE,MANNA,305,15,290,1425,27550
2003,OPTION,MANNA,828,17,811,1615,77045
2003,STOCK,MANNA,339,46,293,4370,27835
2003,FUTURE,LUPIN,608,470,138,44650,13110
2003,OPTION,LUPIN,579,222,357,21090,33915
2003,STOCK,LUPIN,380,195,185,18525,17575
2003,FUTURE,DRL,461,176,285,16720,27075
2003,OPTION,DRL,371,118,253,11210,24035
2003,STOCK,DRL,883,519,364,49305,34580
2003,FUTURE,TCIL,922,366,556,34770,52820
2003,OPTION,TCIL,290,276,14,26220,1330
2003,STOCK,TCIL,819,650,169,61750,16055
2003,FUTURE,CONCUR,995,535,460,50825,43700
2003,OPTION,CONCUR,636,509,127,48355,12065
2003,STOCK,CONCUR,916,872,44,82840,4180
2004,FUTURE,NIFTY,798,638,160,60610,15200
2004,OPTION,NIFTY,792,226,566,21470,53770
2004,STOCK,NIFTY,221,11,210,1045,19950
2004,FUTURE,RELIANCE,634,25,609,2375,57855
2004,OPTION,RELIANCE,770,510,260,48450,24700
2004,STOCK,RELIANCE,474,414,60,39330,5700
2004,FUTURE,SBIN,443,118,325,11210,30875
2004,OPTION,SBIN,497,116,381,11020,36195
2004,STOCK,SBIN,858,711,147,67545,13965
2004,FUTURE,ICICI,761,494,267,46930,25365
2004,OPTION,ICICI,384,74,310,7030,29450
2004,STOCK,ICICI,585,320,265,30400,25175
2004,FUTURE,LT,350,78,272,7410,25840
2004,OPTION,LT,933,78,855,7410,81225
2004,STOCK,LT,268,39,229,3705,21755
2004,FUTURE,CIPLA,596,49,547,4655,51965
2004,OPTION,CIPLA,465,81,384,7695,36480
2004,STOCK,CIPLA,994,462,532,43890,50540
2004,FUTURE,ONGC,312,107,205,10165,19475
2004,OPTION,ONGC,454,359,95,34105,9025
2004,STOCK,ONGC,566,151,415,14345,39425
2004,FUTURE,DLF,426,2,424,190,40280
2004,OPTION,DLF,389,304,85,28880,8075
2004,STOCK,DLF,506,9,497,855,47215
2004,FUTURE,UNILEVER,523,282,241,26790,22895
2004,OPTION,UNILEVER,431,197,234,18715,22230
2004,STOCK,UNILEVER,532,460,72,43700,6840
2004,FUTURE,APOLLO,872,515,357,48925,33915
2004,OPTION,APOLLO,929,534,395,50730,37525
2004,STOCK,APOLLO,220,6,214,570,20330
2004,FUTURE,BHEL,527,126,401,11970,38095
2004,OPTION,BHEL,591,453,138,43035,13110
2004,STOCK,BHEL,313,283,30,26885,2850
2004,FUTURE,SRIRAM,911,583,328,55385,31160
2004,OPTION,SRIRAM,531,203,328,19285,31160
2004,STOCK,SRIRAM,790,728,62,69160,5890
2004,FUTURE,MANNA,576,214,362,20330,34390
2004,OPTION,MANNA,574,329,245,31255,23275
2004,STOCK,MANNA,570,523,47,49685,4465
2004,FUTURE,LUPIN,503,185,318,17575,30210
2004,OPTION,LUPIN,507,268,239,25460,22705
2004,STOCK,LUPIN,721,510,211,48450,20045
2004,FUTURE,DRL,737,177,560,16815,53200
2004,OPTION,DRL,683,681,2,64695,190
2004,STOCK,DRL,867,134,733,12730,69635
2004,FUTURE,TCIL,255,223,32,21185,3040
2004,OPTION,TCIL,309,22,287,2090,27265
2004,STOCK,TCIL,612,489,123,46455,11685
2004,FUTURE,CONCUR,321,127,194,12065,18430
2004,OPTION,CONCUR,539,77,462,7315,43890
2004,STOCK,CONCUR,298,142,156,13490,14820
2005,FUTURE,NIFTY,631,421,210,39995,19950
2005,OPTION,NIFTY,592,551,41,52345,3895
2005,STOCK,NIFTY,758,437,321,41515,30495
2005,FUTURE,RELIANCE,699,118,581,11210,55195
2005,OPTION,RELIANCE,573,274,299,26030,28405
2005,STOCK,RELIANCE,383,319,64,30305,6080
2005,FUTURE,SBIN,397,117,280,11115,26600
2005,OPTION,SBIN,745,489,256,46455,24320
2005,STOCK,SBIN,456,345,111,32775,10545
2005,FUTURE,ICICI,633,619,14,58805,1330
2005,OPTION,ICICI,611,136,475,12920,45125
2005,STOCK,ICICI,862,116,746,11020,70870
2005,FUTURE,LT,935,511,424,48545,40280
2005,OPTION,LT,528,58,470,5510,44650
2005,STOCK,LT,741,451,290,42845,27550
2005,FUTURE,CIPLA,890,594,296,56430,28120
2005,OPTION,CIPLA,799,274,525,26030,49875
2005,STOCK,CIPLA,949,361,588,34295,55860
2005,FUTURE,ONGC,906,477,429,45315,40755
2005,OPTION,ONGC,944,791,153,75145,14535
2005,STOCK,ONGC,773,412,361,39140,34295
2005,FUTURE,DLF,237,11,226,1045,21470
2005,OPTION,DLF,876,624,252,59280,23940
2005,STOCK,DLF,245,236,9,22420,855
2005,FUTURE,UNILEVER,560,409,151,38855,14345
2005,OPTION,UNILEVER,618,547,71,51965,6745
2005,STOCK,UNILEVER,355,60,295,5700,28025
2005,FUTURE,APOLLO,634,404,230,38380,21850
2005,OPTION,APOLLO,753,727,26,69065,2470
2005,STOCK,APOLLO,510,468,42,44460,3990
2005,FUTURE,BHEL,703,319,384,30305,36480
2005,OPTION,BHEL,538,80,458,7600,43510
2005,STOCK,BHEL,409,87,322,8265,30590
2005,FUTURE,SRIRAM,652,0,652,0,61940
2005,OPTION,SRIRAM,518,375,143,35625,13585
2005,STOCK,SRIRAM,777,499,278,47405,26410
2005,FUTURE,MANNA,344,69,275,6555,26125
2005,OPTION,MANNA,416,34,382,3230,36290
2005,STOCK,MANNA,911,22,889,2090,84455
2005,FUTURE,LUPIN,378,364,14,34580,1330
2005,OPTION,LUPIN,971,236,735,22420,69825
2005,STOCK,LUPIN,486,408,78,38760,7410
2005,FUTURE,DRL,294,201,93,19095,8835
2005,OPTION,DRL,484,434,50,41230,4750
2005,STOCK,DRL,786,559,227,53105,21565
2005,FUTURE,TCIL,745,358,387,34010,36765
2005,OPTION,TCIL,569,1,568,95,53960
2005,STOCK,TCIL,747,388,359,36860,34105
2005,FUTURE,CONCUR,567,322,245,30590,23275
2005,OPTION,CONCUR,808,533,275,50635,26125
2005,STOCK,CONCUR,601,554,47,52630,4465
2006,FUTURE,NIFTY,586,248,338,23560,32110
2006,OPTION,NIFTY,535,54,481,5130,45695
2006,STOCK,NIFTY,726,437,289,41515,27455
2006,FUTURE,RELIANCE,215,209,6,19855,570
2006,OPTION,RELIANCE,963,257,706,24415,67070
2006,STOCK,RELIANCE,460,310,150,29450,14250
2006,FUTURE,SBIN,234,110,124,10450,11780
2006,OPTION,SBIN,827,374,453,35530,43035
2006,STOCK,SBIN,365,6,359,570,34105
2006,FUTURE,ICICI,283,233,50,22135,4750
2006,OPTION,ICICI,301,20,281,1900,26695
2006,STOCK,ICICI,227,125,102,11875,9690
2006,FUTURE,LT,796,646,150,61370,14250
2006,OPTION,LT,405,337,68,32015,6460
2006,STOCK,LT,793,384,409,36480,38855
2006,FUTURE,CIPLA,681,581,100,55195,9500
2006,OPTION,CIPLA,202,135,67,12825,6365
2006,STOCK,CIPLA,512,206,306,19570,29070
2006,FUTURE,ONGC,996,410,586,38950,55670
2006,OPTION,ONGC,329,210,119,19950,11305
2006,STOCK,ONGC,937,316,621,30020,58995
2006,FUTURE,DLF,965,153,812,14535,77140
2006,OPTION,DLF,910,78,832,7410,79040
2006,STOCK,DLF,889,555,334,52725,31730
2006,FUTURE,UNILEVER,648,274,374,26030,35530
2006,OPTION,UNILEVER,429,149,280,14155,26600
2006,STOCK,UNILEVER,768,680,88,64600,8360
2006,FUTURE,APOLLO,931,135,796,12825,75620
2006,OPTION,APOLLO,826,481,345,45695,32775
2006,STOCK,APOLLO,339,255,84,24225,7980
2006,FUTURE,BHEL,385,131,254,12445,24130
2006,OPTION,BHEL,536,143,393,13585,37335
2006,STOCK,BHEL,225,210,15,19950,1425
2006,FUTURE,SRIRAM,499,311,188,29545,17860
2006,OPTION,SRIRAM,837,133,704,12635,66880
2006,STOCK,SRIRAM,432,27,405,2565,38475
2006,FUTURE,MANNA,445,308,137,29260,13015
2006,OPTION,MANNA,262,85,177,8075,16815
2006,STOCK,MANNA,349,253,96,24035,9120
2006,FUTURE,LUPIN,274,138,136,13110,12920
2006,OPTION,LUPIN,359,335,24,31825,2280
2006,STOCK,LUPIN,925,777,148,73815,14060
2006,FUTURE,DRL,813,431,382,40945,36290
2006,OPTION,DRL,249,79,170,7505,16150
2006,STOCK,DRL,915,442,473,41990,44935
2006,FUTURE,TCIL,568,75,493,7125,46835
2006,OPTION,TCIL,376,102,274,9690,26030
2006,STOCK,TCIL,876,822,54,78090,5130
2006,FUTURE,CONCUR,314,95,219,9025,20805
2006,OPTION,CONCUR,600,54,546,5130,51870
2006,STOCK,CONCUR,310,215,95,20425,9025
2007,FUTURE,NIFTY,957,526,431,49970,40945
2007,OPTION,NIFTY,466,448,18,42560,1710
2007,STOCK,NIFTY,603,339,264,32205,25080
2007,FUTURE,RELIANCE,951,521,430,49495,40850
2007,OPTION,RELIANCE,940,43,897,4085,85215
2007,STOCK,RELIANCE,677,521,156,49495,14820
2007,FUTURE,SBIN,380,187,193,17765,18335
2007,OPTION,SBIN,625,238,387,22610,36765
2007,STOCK,SBIN,376,348,28,33060,2660
2007,FUTURE,ICICI,776,79,697,7505,66215
2007,OPTION,ICICI,463,376,87,35720,8265
2007,STOCK,ICICI,363,146,217,13870,20615
2007,FUTURE,LT,595,354,241,33630,22895
2007,OPTION,LT,592,451,141,42845,13395
2007,STOCK,LT,878,799,79,75905,7505
2007,FUTURE,CIPLA,378,74,304,7030,28880
2007,OPTION,CIPLA,589,347,242,32965,22990
2007,STOCK,CIPLA,867,420,447,39900,42465
2007,FUTURE,ONGC,316,174,142,16530,13490
2007,OPTION,ONGC,569,374,195,35530,18525
2007,STOCK,ONGC,555,288,267,27360,25365
2007,FUTURE,DLF,294,112,182,10640,17290
2007,OPTION,DLF,883,104,779,9880,74005
2007,STOCK,DLF,847,775,72,73625,6840
2007,FUTURE,UNILEVER,277,240,37,22800,3515
2007,OPTION,UNILEVER,657,73,584,6935,55480
2007,STOCK,UNILEVER,789,413,376,39235,35720
2007,FUTURE,APOLLO,862,213,649,20235,61655
2007,OPTION,APOLLO,626,168,458,15960,43510
2007,STOCK,APOLLO,560,399,161,37905,15295
2007,FUTURE,BHEL,695,656,39,62320,3705
2007,OPTION,BHEL,667,564,103,53580,9785
2007,STOCK,BHEL,297,67,230,6365,21850
2007,FUTURE,SRIRAM,214,83,131,7885,12445
2007,OPTION,SRIRAM,249,240,9,22800,855
2007,STOCK,SRIRAM,650,530,120,50350,11400
2007,FUTURE,MANNA,933,581,352,55195,33440
2007,OPTION,MANNA,759,76,683,7220,64885
2007,STOCK,MANNA,487,202,285,19190,27075
2007,FUTURE,LUPIN,908,250,658,23750,62510
2007,OPTION,LUPIN,861,356,505,33820,47975
2007,STOCK,LUPIN,300,245,55,23275,5225
2007,FUTURE,DRL,668,598,70,56810,6650
2007,OPTION,DRL,358,67,291,6365,27645
2007,STOCK,DRL,621,106,515,10070,48925
2007,FUTURE,TCIL,839,83,756,7885,71820
2007,OPTION,TCIL,746,48,698,4560,66310
2007,STOCK,TCIL,803,162,641,15390,60895
2007,FUTURE,CONCUR,978,321,657,30495,62415
2007,OPTION,CONCUR,930,682,248,64790,23560
2007,STOCK,CONCUR,956,555,401,52725,38095
2008,FUTURE,NIFTY,816,115,701,10925,66595
2008,OPTION,NIFTY,762,659,103,62605,9785
2008,STOCK,NIFTY,279,107,172,10165,16340
2008,FUTURE,RELIANCE,393,59,334,5605,31730
2008,OPTION,RELIANCE,433,27,406,2565,38570
2008,STOCK,RELIANCE,909,380,529,36100,50255
2008,FUTURE,SBIN,864,675,189,64125,17955
2008,OPTION,SBIN,525,342,183,32490,17385
2008,STOCK,SBIN,710,9,701,855,66595
2008,FUTURE,ICICI,347,79,268,7505,25460
2008,OPTION,ICICI,953,845,108,80275,10260
2008,STOCK,ICICI,827,261,566,24795,53770
2008,FUTURE,LT,244,22,222,2090,21090
2008,OPTION,LT,491,225,266,21375,25270
2008,STOCK,LT,780,762,18,72390,1710
2008,FUTURE,CIPLA,692,535,157,50825,14915
2008,OPTION,CIPLA,470,372,98,35340,9310
2008,STOCK,CIPLA,330,251,79,23845,7505
2008,FUTURE,ONGC,388,118,270,11210,25650
2008,OPTION,ONGC,487,59,428,5605,40660
2008,STOCK,ONGC,671,122,549,11590,52155
2008,FUTURE,DLF,759,151,608,14345,57760
2008,OPTION,DLF,695,11,684,1045,64980
2008,STOCK,DLF,931,373,558,35435,53010
2008,FUTURE,UNILEVER,834,573,261,54435,24795
2008,OPTION,UNILEVER,575,142,433,13490,41135
2008,STOCK,UNILEVER,987,705,282,66975,26790
2008,FUTURE,APOLLO,829,600,229,57000,21755
2008,OPTION,APOLLO,976,526,450,49970,42750
2008,STOCK,APOLLO,946,774,172,73530,16340
2008,FUTURE,BHEL,746,610,136,57950,12920
2008,OPTION,BHEL,268,230,38,21850,3610
2008,STOCK,BHEL,964,92,872,8740,82840
2008,FUTURE,SRIRAM,558,486,72,46170,6840
2008,OPTION,SRIRAM,326,29,297,2755,28215
2008,STOCK,SRIRAM,675,584,91,55480,8645
2008,FUTURE,MANNA,206,64,142,6080,13490
2008,OPTION,MANNA,379,17,362,1615,34390
2008,STOCK,MANNA,546,289,257,27455,24415
2008,FUTURE,LUPIN,492,299,193,28405,18335
2008,OPTION,LUPIN,349,245,104,23275,9880
2008,STOCK,LUPIN,585,483,102,45885,9690
2008,FUTURE,DRL,746,29,717,2755,68115
2008,OPTION,DRL,631,276,355,26220,33725
2008,STOCK,DRL,283,146,137,13870,13015
2008,FUTURE,TCIL,407,326,81,30970,7695
2008,OPTION,TCIL,231,179,52,17005,4940
2008,STOCK,TCIL,319,271,48,25745,4560
2008,FUTURE,CONCUR,282,52,230,4940,21850
2008,OPTION,CONCUR,988,839,149,79705,14155
2008,STOCK,CONCUR,269,14,255,1330,24225
2009,FUTURE,NIFTY,955,124,831,11780,78945
2009,OPTION,NIFTY,701,436,265,41420,25175
2009,STOCK,NIFTY,298,290,8,27550,760
2009,FUTURE,RELIANCE,210,84,126,7980,11970
2009,OPTION,RELIANCE,563,304,259,28880,24605
2009,STOCK,RELIANCE,560,66,494,6270,46930
2009,FUTURE,SBIN,905,194,711,18430,67545
2009,OPTION,SBIN,569,400,169,38000,16055
2009,STOCK,SBIN,319,288,31,27360,2945
2009,FUTURE,ICICI,517,229,288,21755,27360
2009,OPTION,ICICI,507,468,39,44460,3705
2009,STOCK,ICICI,509,460,49,43700,4655
2009,FUTURE,LT,465,151,314,14345,29830
2009,OPTION,LT,812,427,385,40565,36575
2009,STOCK,LT,951,750,201,71250,19095
2009,FUTURE,CIPLA,221,122,99,11590,9405
2009,OPTION,CIPLA,426,4,422,380,40090
2009,STOCK,CIPLA,933,850,83,80750,7885
2009,FUTURE,ONGC,872,592,280,56240,26600
2009,OPTION,ONGC,757,159,598,15105,56810
2009,STOCK,ONGC,839,395,444,37525,42180
2009,FUTURE,DLF,723,662,61,62890,5795
2009,OPTION,DLF,330,222,108,21090,10260
2009,STOCK,DLF,525,133,392,12635,37240
2009,FUTURE,UNILEVER,277,34,243,3230,23085
2009,OPTION,UNILEVER,968,803,165,76285,15675
2009,STOCK,UNILEVER,566,405,161,38475,15295
2009,FUTURE,APOLLO,498,171,327,16245,31065
2009,OPTION,APOLLO,359,300,59,28500,5605
2009,STOCK,APOLLO,677,624,53,59280,5035
2009,FUTURE,BHEL,246,37,209,3515,19855
2009,OPTION,BHEL,396,367,29,34865,2755
2009,STOCK,BHEL,368,277,91,26315,8645
2009,FUTURE,SRIRAM,725,150,575,14250,54625
2009,OPTION,SRIRAM,781,130,651,12350,61845
2009,STOCK,SRIRAM,319,297,22,28215,2090
2009,FUTURE,MANNA,912,894,18,84930,1710
2009,OPTION,MANNA,389,83,306,7885,29070
2009,STOCK,MANNA,248,245,3,23275,285
2009,FUTURE,LUPIN,385,262,123,24890,11685
2009,OPTION,LUPIN,366,73,293,6935,27835
2009,STOCK,LUPIN,822,324,498,30780,47310
2009,FUTURE,DRL,841,436,405,41420,38475
2009,OPTION,DRL,961,363,598,34485,56810
2009,STOCK,DRL,991,130,861,12350,81795
2009,FUTURE,TCIL,600,118,482,11210,45790
2009,OPTION,TCIL,574,556,18,52820,1710
2009,STOCK,TCIL,479,179,300,17005,28500
2009,FUTURE,CONCUR,219,148,71,14060,6745
2009,OPTION,CONCUR,915,314,601,29830,57095
2009,STOCK,CONCUR,631,98,533,9310,50635
2010,FUTURE,NIFTY,442,100,342,9500,32490
2010,OPTION,NIFTY,764,22,742,2090,70490
2010,STOCK,NIFTY,613,359,254,34105,24130
2010,FUTURE,RELIANCE,825,824,1,78280,95
2010,OPTION,RELIANCE,566,375,191,35625,18145
2010,STOCK,RELIANCE,237,12,225,1140,21375
2010,FUTURE,SBIN,366,339,27,32205,2565
2010,OPTION,SBIN,821,115,706,10925,67070
2010,STOCK,SBIN,567,62,505,5890,47975
2010,FUTURE,ICICI,655,104,551,9880,52345
2010,OPTION,ICICI,972,921,51,87495,4845
2010,STOCK,ICICI,568,18,550,1710,52250
2010,FUTURE,LT,649,4,645,380,61275
2010,OPTION,LT,961,79,882,7505,83790
2010,STOCK,LT,728,456,272,43320,25840
2010,FUTURE,CIPLA,871,525,346,49875,32870
2010,OPTION,CIPLA,525,292,233,27740,22135
2010,STOCK,CIPLA,488,477,11,45315,1045
2010,FUTURE,ONGC,340,143,197,13585,18715
2010,OPTION,ONGC,664,230,434,21850,41230
2010,STOCK,ONGC,276,46,230,4370,21850
2010,FUTURE,DLF,565,97,468,9215,44460
2010,OPTION,DLF,531,385,146,36575,13870
2010,STOCK,DLF,989,453,536,43035,50920
2010,FUTURE,UNILEVER,274,41,233,3895,22135
2010,OPTION,UNILEVER,217,17,200,1615,19000
2010,STOCK,UNILEVER,842,374,468,35530,44460
2010,FUTURE,APOLLO,843,258,585,24510,55575
2010,OPTION,APOLLO,916,345,571,32775,54245
2010,STOCK,APOLLO,383,147,236,13965,22420
2010,FUTURE,BHEL,370,320,50,30400,4750
2010,OPTION,BHEL,906,567,339,53865,32205
2010,STOCK,BHEL,792,699,93,66405,8835
2010,FUTURE,SRIRAM,540,381,159,36195,15105
2010,OPTION,SRIRAM,884,609,275,57855,26125
2010,STOCK,SRIRAM,438,252,186,23940,17670
2010,FUTURE,MANNA,503,18,485,1710,46075
2010,OPTION,MANNA,663,273,390,25935,37050
2010,STOCK,MANNA,583,372,211,35340,20045
2010,FUTURE,LUPIN,693,164,529,15580,50255
2010,OPTION,LUPIN,733,143,590,13585,56050
2010,STOCK,LUPIN,693,284,409,26980,38855
2010,FUTURE,DRL,670,64,606,6080,57570
2010,OPTION,DRL,549,319,230,30305,21850
2010,STOCK,DRL,877,531,346,50445,32870
2010,FUTURE,TCIL,315,58,257,5510,24415
2010,OPTION,TCIL,698,81,617,7695,58615
2010,STOCK,TCIL,691,335,356,31825,33820
2010,FUTURE,CONCUR,908,474,434,45030,41230
2010,OPTION,CONCUR,649,413,236,39235,22420
2010,STOCK,CONCUR,454,341,113,32395,10735
2011,FUTURE,NIFTY,554,138,416,13110,39520
2011,OPTION,NIFTY,837,689,148,65455,14060
2011,STOCK,NIFTY,689,297,392,28215,37240
2011,FUTURE,RELIANCE,396,198,198,18810,18810
2011,OPTION,RELIANCE,839,8,831,760,78945
2011,STOCK,RELIANCE,480,418,62,39710,5890
2011,FUTURE,SBIN,359,178,181,16910,17195
2011,OPTION,SBIN,500,319,181,30305,17195
2011,STOCK,SBIN,710,553,157,52535,14915
2011,FUTURE,ICICI,520,48,472,4560,44840
2011,OPTION,ICICI,200,179,21,17005,1995
2011,STOCK,ICICI,536,415,121,39425,11495
2011,FUTURE,LT,638,67,571,6365,54245
2011,OPTION,LT,887,384,503,36480,47785
2011,STOCK,LT,405,376,29,35720,2755
2011,FUTURE,CIPLA,854,637,217,60515,20615
2011,OPTION,CIPLA,592,397,195,37715,18525
2011,STOCK,CIPLA,504,253,251,24035,23845
2011,FUTURE,ONGC,793,561,232,53295,22040
2011,OPTION,ONGC,509,66,443,6270,42085
2011,STOCK,ONGC,523,417,106,39615,10070
2011,FUTURE,DLF,968,561,407,53295,38665
2011,OPTION,DLF,663,604,59,57380,5605
2011,STOCK,DLF,842,597,245,56715,23275
2011,FUTURE,UNILEVER,702,566,136,53770,12920
2011,OPTION,UNILEVER,923,16,907,1520,86165
2011,STOCK,UNILEVER,365,350,15,33250,1425
2011,FUTURE,APOLLO,979,346,633,32870,60135
2011,OPTION,APOLLO,938,194,744,18430,70680
2011,STOCK,APOLLO,788,259,529,24605,50255
2011,FUTURE,BHEL,507,488,19,46360,1805
2011,OPTION,BHEL,670,209,461,19855,43795
2011,STOCK,BHEL,929,368,561,34960,53295
2011,FUTURE,SRIRAM,761,501,260,47595,24700
2011,OPTION,SRIRAM,795,379,416,36005,39520
2011,STOCK,SRIRAM,556,357,199,33915,18905
2011,FUTURE,MANNA,364,18,346,1710,32870
2011,OPTION,MANNA,907,73,834,6935,79230
2011,STOCK,MANNA,836,543,293,51585,27835
2011,FUTURE,LUPIN,621,383,238,36385,22610
2011,OPTION,LUPIN,664,272,392,25840,37240
2011,STOCK,LUPIN,334,163,171,15485,16245
2011,FUTURE,DRL,916,825,91,78375,8645
2011,OPTION,DRL,966,822,144,78090,13680
2011,STOCK,DRL,612,249,363,23655,34485
2011,FUTURE,TCIL,944,57,887,5415,84265
2011,OPTION,TCIL,732,49,683,4655,64885
2011,STOCK,TCIL,580,406,174,38570,16530
2011,FUTURE,CONCUR,683,162,521,15390,49495
2011,OPTION,CONCUR,589,480,109,45600,10355
2011,STOCK,CONCUR,557,315,242,29925,22990
2012,FUTURE,NIFTY,294,175,119,16625,11305
2012,OPTION,NIFTY,327,152,175,14440,16625
2012,STOCK,NIFTY,552,316,236,30020,22420
2012,FUTURE,RELIANCE,727,439,288,41705,27360
2012,OPTION,RELIANCE,355,64,291,6080,27645
2012,STOCK,RELIANCE,980,706,274,67070,26030
2012,FUTURE,SBIN,286,180,106,17100,10070
2012,OPTION,SBIN,247,55,192,5225,18240
2012,STOCK,SBIN,857,538,319,51110,30305
2012,FUTURE,ICICI,866,443,423,42085,40185
2012,OPTION,ICICI,374,317,57,30115,5415
2012,STOCK,ICICI,436,304,132,28880,12540
2012,FUTURE,LT,329,47,282,4465,26790
2012,OPTION,LT,377,183,194,17385,18430
2012,STOCK,LT,482,204,278,19380,26410
2012,FUTURE,CIPLA,843,397,446,37715,42370
2012,OPTION,CIPLA,940,266,674,25270,64030
2012,STOCK,CIPLA,450,2,448,190,42560
2012,FUTURE,ONGC,413,400,13,38000,1235
2012,OPTION,ONGC,697,654,43,62130,4085
2012,STOCK,ONGC,437,305,132,28975,12540
2012,FUTURE,DLF,436,326,110,30970,10450
2012,OPTION,DLF,588,370,218,35150,20710
2012,STOCK,DLF,843,703,140,66785,13300
2012,FUTURE,UNILEVER,677,676,1,64220,95
2012,OPTION,UNILEVER,447,101,346,9595,32870
2012,STOCK,UNILEVER,549,224,325,21280,30875
2012,FUTURE,APOLLO,543,362,181,34390,17195
2012,OPTION,APOLLO,508,92,416,8740,39520
2012,STOCK,APOLLO,693,628,65,59660,6175
2012,FUTURE,BHEL,485,268,217,25460,20615
2012,OPTION,BHEL,637,547,90,51965,8550
2012,STOCK,BHEL,937,558,379,53010,36005
2012,FUTURE,SRIRAM,457,155,302,14725,28690
2012,OPTION,SRIRAM,457,170,287,16150,27265
2012,STOCK,SRIRAM,798,265,533,25175,50635
2012,FUTURE,MANNA,358,215,143,20425,13585
2012,OPTION,MANNA,312,248,64,23560,6080
2012,STOCK,MANNA,210,167,43,15865,4085
2012,FUTURE,LUPIN,347,183,164,17385,15580
2012,OPTION,LUPIN,444,268,176,25460,16720
2012,STOCK,LUPIN,767,123,644,11685,61180
2012,FUTURE,DRL,902,758,144,72010,13680
2012,OPTION,DRL,296,32,264,3040,25080
2012,STOCK,DRL,845,47,798,4465,75810
2012,FUTURE,TCIL,642,259,383,24605,36385
2012,OPTION,TCIL,312,110,202,10450,19190
2012,STOCK,TCIL,691,26,665,2470,63175
2012,FUTURE,CONCUR,289,203,86,19285,8170
2012,OPTION,CONCUR,549,411,138,39045,13110
2012,STOCK,CONCUR,934,148,786,14060,74670
2013,FUTURE,NIFTY,230,180,50,17100,4750
2013,OPTION,NIFTY,723,626,97,59470,9215
2013,STOCK,NIFTY,796,516,280,49020,26600
2013,FUTURE,RELIANCE,216,87,129,8265,12255
2013,OPTION,RELIANCE,450,214,236,20330,22420
2013,STOCK,RELIANCE,357,222,135,21090,12825
2013,FUTURE,SBIN,677,374,303,35530,28785
2013,OPTION,SBIN,327,86,241,8170,22895
2013,STOCK,SBIN,432,346,86,32870,8170
2013,FUTURE,ICICI,684,174,510,16530,48450
2013,OPTION,ICICI,884,811,73,77045,6935
2013,STOCK,ICICI,809,781,28,74195,2660
2013,FUTURE,LT,718,641,77,60895,7315
2013,OPTION,LT,636,280,356,26600,33820
2013,STOCK,LT,299,12,287,1140,27265
2013,FUTURE,CIPLA,269,57,212,5415,20140
2013,OPTION,CIPLA,506,195,311,18525,29545
2013,STOCK,CIPLA,881,170,711,16150,67545
2013,FUTURE,ONGC,912,538,374,51110,35530
2013,OPTION,ONGC,458,228,230,21660,21850
2013,STOCK,ONGC,551,358,193,34010,18335
2013,FUTURE,DLF,556,103,453,9785,43035
2013,OPTION,DLF,497,115,382,10925,36290
2013,STOCK,DLF,229,86,143,8170,13585
2013,FUTURE,UNILEVER,225,214,11,20330,1045
2013,OPTION,UNILEVER,870,696,174,66120,16530
2013,STOCK,UNILEVER,634,544,90,51680,8550
2013,FUTURE,APOLLO,921,77,844,7315,80180
2013,OPTION,APOLLO,600,14,586,1330,55670
2013,STOCK,APOLLO,519,234,285,22230,27075
2013,FUTURE,BHEL,469,129,340,12255,32300
2013,OPTION,BHEL,465,116,349,11020,33155
2013,STOCK,BHEL,635,456,179,43320,17005
2013,FUTURE,SRIRAM,200,103,97,9785,9215
2013,OPTION,SRIRAM,468,200,268,19000,25460
2013,STOCK,SRIRAM,669,492,177,46740,16815
2013,FUTURE,MANNA,678,143,535,13585,50825
2013,OPTION,MANNA,307,115,192,10925,18240
2013,STOCK,MANNA,584,16,568,1520,53960
2013,FUTURE,LUPIN,725,268,457,25460,43415
2013,OPTION,LUPIN,375,160,215,15200,20425
2013,STOCK,LUPIN,699,191,508,18145,48260
2013,FUTURE,DRL,312,90,222,8550,21090
2013,OPTION,DRL,486,128,358,12160,34010
2013,STOCK,DRL,485,409,76,38855,7220
2013,FUTURE,TCIL,513,228,285,21660,27075
2013,OPTION,TCIL,203,128,75,12160,7125
2013,STOCK,TCIL,341,317,24,30115,2280
2013,FUTURE,CONCUR,983,9,974,855,92530
2013,OPTION,CONCUR,571,60,511,5700,48545
2013,STOCK,CONCUR,413,111,302,10545,28690
2014,FUTURE,NIFTY,337,71,266,6745,25270
2014,OPTION,NIFTY,227,76,151,7220,14345
2014,STOCK,NIFTY,717,176,541,16720,51395
2014,FUTURE,RELIANCE,680,117,563,11115,53485
2014,OPTION,RELIANCE,550,33,517,3135,49115
2014,STOCK,RELIANCE,335,150,185,14250,17575
2014,FUTURE,SBIN,789,74,715,7030,67925
2014,OPTION,SBIN,532,529,3,50255,285
2014,STOCK,SBIN,385,56,329,5320,31255
2014,FUTURE,ICICI,903,638,265,60610,25175
2014,OPTION,ICICI,507,474,33,45030,3135
2014,STOCK,ICICI,884,74,810,7030,76950
2014,FUTURE,LT,214,45,169,4275,16055
2014,OPTION,LT,261,243,18,23085,1710
2014,STOCK,LT,319,33,286,3135,27170
2014,FUTURE,CIPLA,253,102,151,9690,14345
2014,OPTION,CIPLA,924,204,720,19380,68400
2014,STOCK,CIPLA,773,720,53,68400,5035
2014,FUTURE,ONGC,421,99,322,9405,30590
2014,OPTION,ONGC,987,54,933,5130,88635
2014,STOCK,ONGC,566,156,410,14820,38950
2014,FUTURE,DLF,318,30,288,2850,27360
2014,OPTION,DLF,964,328,636,31160,60420
2014,STOCK,DLF,332,264,68,25080,6460
2014,FUTURE,UNILEVER,572,14,558,1330,53010
2014,OPTION,UNILEVER,641,83,558,7885,53010
2014,STOCK,UNILEVER,472,348,124,33060,11780
2014,FUTURE,APOLLO,282,176,106,16720,10070
2014,OPTION,APOLLO,951,230,721,21850,68495
2014,STOCK,APOLLO,609,8,601,760,57095
2014,FUTURE,BHEL,602,560,42,53200,3990
2014,OPTION,BHEL,644,459,185,43605,17575
2014,STOCK,BHEL,434,172,262,16340,24890
2014,FUTURE,SRIRAM,843,688,155,65360,14725
2014,OPTION,SRIRAM,317,123,194,11685,18430
2014,STOCK,SRIRAM,748,548,200,52060,19000
2014,FUTURE,MANNA,630,223,407,21185,38665
2014,OPTION,MANNA,435,209,226,19855,21470
2014,STOCK,MANNA,473,182,291,17290,27645
2014,FUTURE,LUPIN,477,391,86,37145,8170
2014,OPTION,LUPIN,908,874,34,83030,3230
2014,STOCK,LUPIN,624,108,516,10260,49020
2014,FUTURE,DRL,845,408,437,38760,41515
2014,OPTION,DRL,433,65,368,6175,34960
2014,STOCK,DRL,520,466,54,44270,5130
2014,FUTURE,TCIL,640,279,361,26505,34295
2014,OPTION,TCIL,321,300,21,28500,1995
2014,STOCK,TCIL,278,78,200,7410,19000
2014,FUTURE,CONCUR,653,354,299,33630,28405
2014,OPTION,CONCUR,791,228,563,21660,53485
2014,STOCK,CONCUR,380,307,73,29165,6935
2015,FUTURE,NIFTY,696,500,196,47500,18620
2015,OPTION,NIFTY,600,232,368,22040,34960
2015,STOCK,NIFTY,204,14,190,1330,18050
2015,FUTURE,RELIANCE,983,213,770,20235,73150
2015,OPTION,RELIANCE,840,306,534,29070,50730
2015,STOCK,RELIANCE,535,48,487,4560,46265
2015,FUTURE,SBIN,619,198,421,18810,39995
2015,OPTION,SBIN,294,226,68,21470,6460
2015,STOCK,SBIN,590,372,218,35340,20710
2015,FUTURE,ICICI,639,600,39,57000,3705
2015,OPTION,ICICI,205,163,42,15485,3990
2015,STOCK,ICICI,342,12,330,1140,31350
2015,FUTURE,LT,425,61,364,5795,34580
2015,OPTION,LT,409,79,330,7505,31350
2015,STOCK,LT,316,65,251,6175,23845
2015,FUTURE,CIPLA,706,71,635,6745,60325
2015,OPTION,CIPLA,717,467,250,44365,23750
2015,STOCK,CIPLA,964,624,340,59280,32300
2015,FUTURE,ONGC,284,75,209,7125,19855
2015,OPTION,ONGC,365,132,233,12540,22135
2015,STOCK,ONGC,357,132,225,12540,21375
2015,FUTURE,DLF,479,275,204,26125,19380
2015,OPTION,DLF,232,194,38,18430,3610
2015,STOCK,DLF,785,209,576,19855,54720
2015,FUTURE,UNILEVER,363,271,92,25745,8740
2015,OPTION,UNILEVER,717,33,684,3135,64980
2015,STOCK,UNILEVER,504,22,482,2090,45790
2015,FUTURE,APOLLO,838,57,781,5415,74195
2015,OPTION,APOLLO,615,189,426,17955,40470
2015,STOCK,APOLLO,525,132,393,12540,37335
2015,FUTURE,BHEL,742,379,363,36005,34485
2015,OPTION,BHEL,285,218,67,20710,6365
2015,STOCK,BHEL,396,189,207,17955,19665
2015,FUTURE,SRIRAM,753,416,337,39520,32015
2015,OPTION,SRIRAM,916,638,278,60610,26410
2015,STOCK,SRIRAM,216,116,100,11020,9500
2015,FUTURE,MANNA,408,176,232,16720,22040
2015,OPTION,MANNA,360,191,169,18145,16055
2015,STOCK,MANNA,502,73,429,6935,40755
2015,FUTURE,LUPIN,806,113,693,10735,65835
2015,OPTION,LUPIN,882,707,175,67165,16625
2015,STOCK,LUPIN,427,23,404,2185,38380
2015,FUTURE,DRL,730,467,263,44365,24985
2015,OPTION,DRL,940,775,165,73625,15675
2015,STOCK,DRL,576,39,537,3705,51015
2015,FUTURE,TCIL,850,498,352,47310,33440
2015,OPTION,TCIL,865,57,808,5415,76760
2015,STOCK,TCIL,930,150,780,14250,74100
2015,FUTURE,CONCUR,354,197,157,18715,14915
2015,OPTION,CONCUR,244,137,107,13015,10165
2015,STOCK,CONCUR,348,264,84,25080,7980
